R 1200 600

NO ./cubassets/wood.xpm
SO ./cubassets/redbrick.xpm
WE ./cubassets/stone.xpm
EA ./cubassets/mossy.xpm
HU ./cubassets/hud3.xpm
S ./cubassets/sp3.xpm
F 86,12,12
C 10,151,176


11111111111111
1S000000000001
10000000000001
11000110000001
12000a00000001
11111111111111

1111111
1b00021
1000001
10000c1
1111111

1111111
1d00021
1000021
10000e1
1111111

1111111
1f00021
1000021
1000021
1111111