R 1600 900

NO ./cubassets/wood.xpm
SO ./cubassets/redbrick.xpm
WE ./cubassets/stone.xpm
EA ./cubassets/mossy.xpm
HU ./cubassets/hud3.xpm
S ./cubassets/sp3.xpm
F 86,12,22
C 10,151,176

1111111111  1111111111  1111111111  
1S00000021  1b00000021  1d00000021  
1000000001  1000000021  1000000021  
1000000001111000000001  1000000021  
1000000000000000000001  1000000001  
10000000a11110000000c1  10000000e1  
1111111111111111111111  1111111111

11111 11111 11 11 111

1111111111  1111111111  1111111111  
1f00000021  1h00000021  1j00000001  
1000000021  1000000021  1000000001  
1000000021  1000000021  1000000001  
1000000021  1000000021  1000000001  
10000000g1  1000000i21  1000000001  
1111111111  1111111111  1111111111
