R 1000 500

NO ./cubassets/wood.xpm
SO ./cubassets/redbrick.xpm
WE ./cubassets/stone.xpm
EA ./cubassets/mossy.xpm
HU ./cubassets/hud3.xpm
S ./cubassets/sp2.xpm
F 86,12,22
C 10,151,176

   1111111111111
  110000000000011    111111
 11000000000000011111100001
110000000N00000000000000001
 11000000000000011111100001
  110000000000011    111111
   1111111111111     111111