R 1600 900

NO ./cubassets/wood.xpm
SO ./cubassets/redbrick.xpm
WE ./cubassets/stone.xpm
EA ./cubassets/mossy.xpm
HU ./cubassets/hud3.xpm
S ./cubassets/sp3.xpm
F 86,12,22
C 10,151,176

1111111111
1a002000d1
1b000000e1
1c000N00f1
1111111111