R 1000 500

NO ./cubassets/wood.xpm
SO ./cubassets/redbrick.xpm
WE ./cubassets/stone.xpm
EA ./cubassets/mossy.xpm
HU ./cubassets/hud3.xpm
S ./cubassets/sp3.xpm
F 86,12,22
C 10,151,176

11111111111111111111111111111111111
10000000000000000000000000000000001
10000002020202020202020202020000001
10000000000000000000000000000000001
10000002020202020202020202020000001
10000000000000000000000000000000001
10000002020202020202020202020000001
10000000000000000000000000000000001
10000002020202020202020202020000001
10000000000000000000000000000000001
10000002020202020202020202020000001
10000000000000000000000000000000001
10000000000000000E00000000000000001
11111111111111111111111111111111111