R 1600 900

NO ./cubassets/wood.xpm
SO ./cubassets/redbrick.xpm
WE ./cubassets/stone.xpm
EA ./cubassets/mossy.xpm
HU ./cubassets/hud3.xpm
S ./cubassets/sp3.xpm
F 86,12,22
C 10,151,176

11111111111111111111111111111111111
10000000000000000000000000000000W01
10000002222222222222222222222222221
10000000000000000000000000000000001
11111112121212121212121212121212001
10000000000000000000000000000000001
10000002121212121000121212121212121
10000000000000000000000000000000001
11111112222222221112221111222222001
10000000000000000000000000000000001
11111112222222220022222222222222221
10000000000000000000000000000000001
10011112222222221111222222222222221
11111111111111111111111111111111111

11111111111111111111111111111111111
10000000000000000000000000000000001
10000000000000000000000000000000001
10000000000000000000000000000000001
10000000000000000000000000000000001
10000000000000000000000000000000001
10000000000000000000000000000000001
10000000000000000000000000000000001
12222111000000000000000000000000001
10000000000000000000000000000000001
10222111000000000000000000000000001
10200000000000000000000000000000001
10200000000000000000000000000000001
11111111111111111111111111111111111