R 100 90

NO ./cubassets/wood.xpm
SO ./cubassets/redbrick.xpm
WE ./cubassets/stone.xpm
EA ./cubassets/mossy.xpm
HU ./cubassets/hud3.xpm
S ./cubassets/sp2.xpm
F 86,12,22
C 10,151,176

1111111111111
1000000000001
1000000000001
1W00000000001
1000000000001
1000000000001
1111111111111